а --> у
б --> щ
в --> э
г --> г
д --> ы
е --> к
ж --> е
з --> р
и --> д
к --> ю
л --> а
м --> п
н --> и
о --> я
п --> л
р --> ь
с --> н
т --> з
у --> х
ф --> ц
х --> ч
ц --> с
ч --> м
ш --> б
щ --> т
ы --> ж
ь --> ш
э --> ф
ю --> в
я --> о
