А -> Г
Б -> Ь
В -> Ф
Г -> Э
Д -> М
Е -> А
Ж -> К
З -> Ш
И -> П
К -> Х
Л -> Л
М -> З
Н -> Ж
О -> И
П -> Б
Р -> Ц
С -> Ю
Т -> Н
У -> В
Ф -> О
Х -> Р
Ц -> Щ
Ч -> У
Ш -> Т
Щ -> Я
Ы -> Ч
Ь -> С
Э -> Д
Ю -> Ы
Я -> Е
[ ]-> Ъ
